103,103,103,103,103,103,103,103,103,103,103,103,103,103,103,103,103,103,103,103,103,103,103,103,103,103,103,103,103
103,103,103,103,103,103,103,103,103,103,103,103,103,103,103,103,103,103,103,103,103,103,103,103,103,103,103,103,103
103,103,103,103,103,103,103,103,103,103,103,103,103,103,103,103,103,103,103,103,103,103,103,103,103,103,103,103,103
103,103,103,103,103,103,103,103,103,103,103,103,103,103,39,103,103,103,103,103,103,103,103,103,103,103,103,103,103
103,39,39,39,39,39,39,39,103,103,103,103,103,103,39,103,103,103,103,103,103,103,103,103,103,103,103,103,103
103,39,103,103,103,103,103,39,103,103,103,103,103,103,39,103,103,103,103,103,103,39,39,39,39,39,103,103,103
103,39,103,103,103,103,103,39,39,39,39,39,39,39,39,103,39,39,39,39,39,39,103,103,103,39,103,103,103
103,39,103,103,103,103,103,103,103,103,103,103,103,103,103,103,39,103,103,103,103,103,103,103,103,39,103,103,103
103,39,103,103,39,39,39,39,39,39,39,39,103,103,103,103,39,103,103,103,103,103,103,103,103,39,103,103,103
103,39,103,103,39,103,103,103,103,103,103,39,103,103,103,103,39,103,103,103,103,103,103,103,103,39,103,103,103
103,39,39,39,39,103,103,103,103,103,103,39,103,103,103,103,39,103,103,103,103,103,103,103,103,39,103,103,103
103,103,103,103,39,103,103,103,103,103,103,39,103,103,103,103,39,39,39,39,103,103,103,103,103,39,103,103,103
103,103,103,103,39,39,39,39,39,39,39,39,103,103,103,103,39,103,103,39,39,39,39,39,39,39,103,103,103
103,103,103,103,103,103,103,103,103,103,103,39,103,103,103,103,39,103,103,103,103,103,103,103,103,103,103,103,103
103,103,103,103,103,103,103,103,103,103,103,39,39,39,39,39,39,103,103,103,103,39,39,39,39,103,103,103,103
103,103,103,103,103,103,103,103,103,103,103,39,103,103,103,103,39,103,103,103,103,39,103,103,39,103,103,103,103
103,103,103,103,103,103,103,103,103,103,103,39,103,103,103,103,39,103,103,103,103,39,103,103,39,39,39,39,103
103,103,103,39,39,39,39,39,39,39,103,39,103,103,103,103,39,103,103,103,103,39,103,103,39,103,103,39,103
103,103,103,39,103,103,103,103,103,39,103,39,39,39,39,39,39,39,39,39,39,39,39,39,39,103,103,39,103
103,103,103,39,103,39,39,39,103,39,103,39,103,103,103,103,39,103,103,103,103,103,103,103,103,103,103,39,103
103,103,103,39,103,39,103,39,103,39,103,39,103,103,103,103,39,103,103,39,39,39,39,39,39,39,103,39,103
103,103,103,39,103,39,103,103,103,39,39,39,103,103,103,103,39,103,103,39,103,103,103,103,103,39,103,39,103
103,103,103,39,103,39,39,39,39,39,103,103,103,103,103,103,39,39,39,39,103,103,103,103,103,39,103,39,103
103,103,103,39,103,103,103,103,103,103,103,103,103,103,103,103,103,103,103,103,103,103,103,103,103,39,103,39,103
103,103,103,39,39,39,39,39,39,39,39,39,39,39,39,39,39,39,39,39,39,39,39,39,39,39,103,39,103
103,103,103,103,103,103,103,103,39,103,103,103,103,103,103,103,103,103,39,103,103,39,103,103,103,103,103,39,103
103,103,103,103,103,103,103,103,39,39,39,39,39,103,39,39,39,39,39,103,103,39,39,39,39,39,39,39,103
103,103,103,103,103,103,103,103,103,103,103,103,103,103,39,103,103,103,103,103,103,103,103,103,103,103,103,103,103
103,103,103,103,103,103,103,103,103,103,103,103,103,103,39,103,103,103,103,103,103,103,103,103,103,103,103,103,103
103,103,103,103,103,103,103,103,103,103,103,103,103,103,39,103,103,103,103,103,103,103,103,103,103,103,103,103,103
